000000000000000
000000900000000
000000000000000
000000000000000
000000000000000
000000000000000
000000000000000
000000000000000
000000000000000
000000000000000
000000000000000
000000020000000
000000000000000
000000000000000
000000000000000
0101010101010100
000000000000000
010101010101010
000000000000000
010101010101010